"filename", "language", "Go", "comment", "blank", "total"
"/root/CppServer/GoodAssJob/GoWebServer/WebServer/common/compress/compress.go", "Go", 165, 5, 12, 182
"/root/CppServer/GoodAssJob/GoWebServer/WebServer/common/compress/decompress.go", "Go", 164, 15, 22, 201
"/root/CppServer/GoodAssJob/GoWebServer/WebServer/common/rcmd/recommend.go", "Go", 106, 3, 14, 123
"/root/CppServer/GoodAssJob/GoWebServer/WebServer/controller/articleController.go", "Go", 156, 6, 23, 185
"/root/CppServer/GoodAssJob/GoWebServer/WebServer/controller/indexController.go", "Go", 17, 0, 3, 20
"/root/CppServer/GoodAssJob/GoWebServer/WebServer/controller/mapController.go", "Go", -6, 0, -2, -8
"/root/CppServer/GoodAssJob/GoWebServer/WebServer/controller/userController.go", "Go", 10, 0, 3, 13
"/root/CppServer/GoodAssJob/GoWebServer/WebServer/db/db.go", "Go", -15, 42, 2, 29
"/root/CppServer/GoodAssJob/GoWebServer/WebServer/main.go", "Go", 0, 0, -1, -1
"/root/CppServer/GoodAssJob/GoWebServer/WebServer/model/model.go", "Go", 17, 1, 2, 20
"Total", "-", 614, 72, 78, 764